1111111111111
1001000000001
1001111100001
1P1001E000001
1000000000001
100000G000001
1000000000001
1111111111111