11111111111111111111111111111111111
1000GGGGGGGGGGGGGGGGGGGGGGGGGGG0001
10001111111111111111111111111110001
1G1CCCCCCCCCCCCCCCCCCCCCCCCCCCCC1G1
1G1C010000111100001111000011110C1G1
1G1C010000000100000001000000010C1G1
1G1C010000000100000001000000010C1G1
1G1C010000000100000001000000010C1G1
1G1C010000111100001111000000010C1G1
1G1C010000000100000001000000010C1G1
1G1C010000000100000001000000010C1G1
1G1C010000000100000001000000010C1G1
1G1P010000111100001111000000010C1G1
1G1CCCCCCCCCCCCCCCCCCCCCCCCCCCCC1G1
10001111111111111111111111111110001
1000GGGGGGGGGGGGGGGGGGGGGGGGGE00001
11111111111111111111111111111111111