11111111111111111111111111111111111111111111111111111
10000000000000000000000000000000000000000000000000001
10CCCCCCCCCCCCCCCCCCCCCCCCCCCCCCCCCCCCCCCCCCCCCCCCC01
10C00000000000000000E00000000000000000000000000000C01
10C01000000010111110101111100000001111101000010000C01
10C01100000110100010100010000000001000101000010000C01
10C01010001010100010100010000000001000101000010000C01
10C010010100101000101000100000P0001000101000010000C01
10C01000100010111110100010000111001111101000010000C01
10C01000000010100010100010000000001000101000010000C01
10C01000000010100010100010000000001000101000010000C01
10C01000000010100010100010000000001000101000010000C01
10C01000000010100010100010000000001000101000010000C01
10C01000000010100010100010000000001000101111011110C01
10C00000000000000000000000000000000000000000000000C01
10CCCCCCCCCCCCCCCCCCCCCCCCCCCCCCCCCCCCCCCCCCCCCCCCC01
10000000000000000000000000000000000000000000000000001
11111111111111111111111111111111111111111111111111111