1111111111111
1001CCCCCCCC1
10CCC111110C1
1P1001ECCCCC1
1C000000000C1
1C000000000C1
1CCCCCCCCCCC1
1111111111111
