111111111111111111111111111111
1000000000000000000000000000G1
100100001111000011110000111101
1001000000010000000100000001C1
100100000001000000010000000101
100100000001000000010000000101
100100001111000011110000000101
100100000001000000010000000101
100100000001000000010000000101
100100000001000000010000000101
1P01000011110000111100000001E1
100000000000000000000000000001
111111111111111111111111111111