111111111111
100100000001
100001011011
1P0011E0G0C1
111111111111
