111111111111
1001000000G1
100001011011
1P0G11E100C1
111111111111
