1111111111111
1GG1G000G00C1
10010000G00C1
1G010000000C1
1001000C000C1
1001000CCCCG1
1000011111001
1P011E00000G1
1111111111111