111111111111
10G1000000G1
100001011011
1P0011E100C1
111111111111
