1111111111111
1001G00G0G0C1
1000010110111
1P0011E1001C1
1111111111111
