1111111111111
1010000000001
10010000000C1
1001000CCCC01
1000011111001
1P011E0000001
1111111111111
