11111111111111111111111111111111111111111111111111111111111
10100000000000000000000000000000000000000000000000001110001
10010000000000000000000000000000000000000000000000001000C01
100100000000000000000000000000000000000000000000000111000C1
100100000000000000000000000000000000000000000000000000000C1
1001000C0000000000000000000000000000000000000000000010000C1
1001000C0000000000000000000000000000000000000000000010000C1
1001000C0000000000000000000000000000000000000000000010000C1
1001000C0000000000000000000000000000000000000000000010000C1
1001000C0000000000000000000000000000000000000000000010000C1
1001000C0000000000000000000000000000000000000000000010000C1
1001000C0000000000000000000000000000000000000000000010000C1
1001000C0000000000000000000000000000000000000000000010000C1
1001000C0000000000000000000000000000000000000000000010000C1
1001000CCCC000000000000000000000000000000000000000000000001
10000111110000000000000000000000000000000000000000000000001
1P011C0E000000000000000000000000000000000000000000000000001
11111111111111111111111111111111111111111111111111111111111