1111111111111
10010000000C1
1000011111011
1P0011E1000C1
1111111111111