1111111111111
100100000G0C1
1000010111011
1P0011E0000C1
1111111111111
