1111111111111
1010000000001
10010000000C1
10010000000C1
1001000C000C1
1001000CCCC01
1000011111001
1P011C0E00001
1111111111111
