1111111111111
1001G00000GC1
1000010110111
1P0011E1000C1
1111111111111
