1111111111111
1001G00G0G0C1
1000010111011
1P0011E000GC1
1111111111111
