1111111111111
1001G0GGG0GC1
10010000000C1
1G010G0G000C1
1G010000000C1
10010G00000C1
1000011111001
1P011E00000G1
1111111111111