1111111111111
1001G00000GC1
10010000000C1
10010000000C1
10010000000C1
10010000000C1
1000011111001
1P011E0000001
1111111111111