1111111111111
10010000000C1
1000010110111
1P0011E1000C1
1111111111111
