1111111111111
101000G0000G1
1001000G000C1
1001G000000C1
1001000C0G0C1
1001000CCCC01
1000011111001
1P011C0E00001
1111111111111