1111111111111
1EG00C00C00C1
10000000000C1
1000000000001
101C1G1C1C1G1
1010101C1C101
1P000000000C1
100C0C00C00C1
1111111111111